34 32
792 1296
1 1 1 1 1 1 1 1 1 1 1 1 1 1 1 1 1 1 1 1 1 1 1 1 1 1 1 1 1 1 1 1 1 1
1 1 1 1 1 1 1 1 1 1 1 1 1 1 1 1 1 1 1 1 1 1 1 1 1 1 1 1 1 1 1 1 1 1
1 1 1 1 1 1 1 1 1 1 1 1 1 1 1 1 1 1 1 1 1 1 1 1 1 1 1 1 1 1 1 1 1 1 
1 1 1 1 1 1 1 1 1 1 1 1 1 1 1 1 1 1 1 1 1 1 1 1 1 1 1 1 1 1 1 1 1 1
1 1 1 1 1 1 1 1 1 1 1 1 1 1 1 1 1 1 1 1 1 1 1 1 1 1 1 1 1 1 1 1 1 1
1 1 1 1 1 1 1 5 5 5 5 5 5 5 5 5 5 5 5 5 5 5 5 5 5 5 5 1 1 1 1 1 1 1
1 1 1 1 1 1 3 6 0 0 6 0 0 6 0 0 0 0 0 0 0 6 0 0 0 0 0 4 1 1 1 1 1 1
1 1 1 1 1 1 3 0 0 0 0 0 6 0 0 0 0 0 0 0 0 0 0 0 0 0 0 4 1 1 1 1 1 1
1 1 1 1 1 1 3 0 6 0 0 0 0 0 0 0 0 0 0 0 0 0 0 11 13 0 0 4 1 1 1 1 1 1
1 1 1 1 1 1 3 0 0 0 6 0 0 0 0 0 0 0 0 0 0 0 0 17 19 0 0 4 1 1 1 1 1 1
1 1 1 1 1 1 3 6 0 0 0 0 0 0 0 0 0 0 0 0 0 0 0 0 0 0 0 4 1 1 1 1 1 1
1 1 1 1 1 1 3 0 0 6 0 0 0 0 0 0 0 0 0 0 0 0 0 6 0 0 0 4 1 1 1 1 1 1
1 1 1 1 1 1 3 0 0 0 0 0 0 0 0 0 0 0 0 0 0 0 0 0 0 0 6 4 1 1 1 1 1 1
1 1 1 1 1 1 3 6 0 0 0 0 0 0 0 0 0 0 0 0 0 0 0 0 0 0 0 4 1 1 1 1 1 1
1 1 1 1 1 1 3 0 0 0 0 6 0 0 0 0 0 0 0 0 0 0 6 0 0 0 0 4 1 1 1 1 1 1
1 1 1 1 1 1 3 0 0 0 0 0 0 0 0 0 0 0 0 0 0 0 0 0 0 0 0 4 1 1 1 1 1 1
1 1 1 1 1 1 3 0 0 0 0 0 0 0 0 0 0 0 0 0 0 0 0 0 6 0 0 4 1 1 1 1 1 1
1 1 1 1 1 1 3 0 11 12 13 0 0 0 0 0 0 0 0 0 0 0 0 0 0 6 0 4 1 1 1 1 1 1
1 1 1 1 1 1 3 0 14 15 16 0 0 0 0 0 0 0 0 6 0 0 0 0 0 0 0 4 1 1 1 1 1 1
1 1 1 1 1 1 3 0 17 18 19 0 0 0 0 0 0 0 0 0 0 0 11 12 12 12 13 4 1 1 1 1 1 1
1 1 1 1 1 1 3 0 0 0 0 0 0 0 0 0 0 0 0 0 0 0 14 15 15 15 16 4 1 1 1 1 1 1
1 1 1 1 1 1 3 6 0 0 0 0 0 0 0 0 0 0 0 0 11 12 15 15 15 15 16 4 1 1 1 1 1 1
1 1 1 1 1 1 3 0 0 0 6 0 0 0 0 0 0 0 0 0 14 15 15 15 15 15 16 4 1 1 1 1 1 1
1 1 1 1 1 1 3 0 0 0 0 0 0 0 0 0 0 0 0 0 14 15 15 15 15 15 16 4 1 1 1 1 1 1
1 1 1 1 1 1 3 0 0 0 0 0 6 0 0 0 0 0 0 0 14 15 15 15 15 15 16 4 1 1 1 1 1 1
1 1 1 1 1 1 3 0 6 0 0 0 0 0 0 0 0 0 0 0 17 18 18 18 18 18 19 4 1 1 1 1 1 1
1 1 1 1 1 1 1 2 2 2 2 2 2 2 8 0 0 0 0 7 2 2 2 2 2 2 2 1 1 1 1 1 1 1 
1 1 1 1 1 1 1 1 1 1 1 1 1 1 3 0 0 0 0 4 1 1 1 1 1 1 1 1 1 1 1 1 1 1
1 1 1 1 1 1 1 1 1 1 1 1 1 1 3 0 0 0 0 4 1 1 1 1 1 1 1 1 1 1 1 1 1 1
1 1 1 1 1 1 1 1 1 1 1 1 1 1 3 0 0 0 0 4 1 1 1 1 1 1 1 1 1 1 1 1 1 1 
1 1 1 1 1 1 1 1 1 1 1 1 1 1 1 2 2 2 2 1 1 1 1 1 1 1 1 1 1 1 1 1 1 1
1 1 1 1 1 1 1 1 1 1 1 1 1 1 1 1 1 1 1 1 1 1 1 1 1 1 1 1 1 1 1 1 1 1
